WE assets/mossy.png
NO assets/eagle.png
SO assets/bluestone.png
EA assets/pillar.png

C 0,255,255
F 0,0,  0

111111111111111111111111111111111111111111111111111111111111111111111
101010100010111000001000000010001000001001000000001000101101010000001
111000000000100000100001010000010000000000110000000101000100001000001
100100000011000000010100000100001010001000000000100000010000010001101
100100001010000000000010000001100000000010000100000100000100001000001
100000000000001100100000010010000000110100100010000010100001010000001
100000000101000000000000100000111000000010010000100000000010010000001
101000000100000000100100100000001010000100010000010110000010001011101
100000010100000111010000010001000010000110000000000001010000000000001
100010000000000000000000001010001010000000000000000000000000100111001
100000000100001000000101111111111111111100000010100011001001101001001
101000110000100000000010000000000000001101000000100001000000000011101
100000001010011000111001000000000000000111100010100000000000001001011
100000001000001010000101000000000000000110000010000100000110000000001
110100000000000000001101000000000000000101100000000000010001100000001
10100000000001010000001000N000000000001100000101000000000101010101001
100011011100011110001011000000000000001100010000010000100100010000001
100000000010000000000001000000000000000100101110000000000000000001001
100100100001000000000001000000000000000100000000000100000000000001001
101000100001000100000001000111111111111110100000000000100000000000001
100010000000001101000001000000000000000101000010000100100000000100001
110000110010001100000001000000000000000100000000010101000000000000001
100000100010000001100001111100000000000100100000000000010000110001001
110000000100000001010001000000000000011101001010100000000000010010001
100000010011000000100011000000000000001100000000101011100000001000001
100001000001110110010011000000000000001100000100000000000010000000011
110010010000100000100111000000000000001111010010000000001000000000001
100010000000001000000001000000000000000101000000000001000001000000001
100000100000001000000001000000000000000110011010000010010101100000101
100010000110000000010011111111111110000100100000011000000010001110011
100000000010001000010010000000000111000100001000000010000000001010001
100100010111010001000000000000000101000000000000000000000101000000001
100001010000000010001000110000000000000000000011010001001010101100011
100000000100000001001000000100000000000100011001110010000000000000101
100000010000100100111001001000000100011100010000000000000000000001101
100101001000010100010000001101001000001010000001000100100000000101011
100110100000000001001000100111100000000000000000100010000110010010001
110100010000000011000000000011000100000000001001000001100001000000001
100001000110000000000000010110010000000010001010000110101000000000001
110110001100010000100010000101000000000000000000100001100000100011101
100001010100100000001011010000010000000000000110000000011110010010001
100000100000000011000001001010001000000000000000000001001000001101111
100001100001100000000000000000001010001001011101000000010100000010001
100001010011000000111000000010000001101100000000001100100100001000011
100100100100100100000100000000010010011000010000011000000100100000001
101000000100100000110011010000101000000010010100000000000000010001101
100000110100000001100100000001100000100000000010010101000001100000001
100000000000000000000000000000000100000010010000000000000100000001001
101001001000000110000001000010000000000000100001010100000001010000101
101100010000000010000100010001000011000101010001000000000010100000001
101110111000000000000000001000100000000100001010000001000001001000001
101000001000010000010011100000101011000000000010001100001001000000011
100001110000000001000011001100010100000100001000100010000000000001011
100100110110010000100010100100101000000000001010010000000000000000001
100001100000000100001000000001001011110010100010000010010100000001001
100000000110100000000000000000100010000000000000010000000010000000001
110000100000000000000001000000001000010000000000001000000000000000001
100000010111000110100001000010000100100111101101010011011001000010001
100011110010010001000000101000001100100000000000110100110001000000001
101100000000000000000100000000000010001000100100000100100001010011001
100000100000000101000001000000100000001000000000010000000000001000001
100000000000000011000100000000000100001010101001000100010000000000101
110000000000000000100010100001010000000000001000000000011000001000001
100010101010000010000000001100101101000010000001111110000001000100001
100011110101000000001000000010010100000010010010000000010110001000001
100000001000100001010000000010000000001000000000000000000000000000001
100001001000000000100001000000010000000100000000101000010010000000101
100000000000001100000000000000000010100010101000000000000100100100101
100000001100010100000010000000010100000101000110000110100100000000001
100010000000001000000000000001100100000010000000100110000010000000001
100010100101001000000000000000000010000001000000000100001000000000001
110000011000100100000000000010000000111000000100001001000010010000111
101000000000010000101000100100111010000000000000000000000000000000001
101010010100101000001010000000000100001010000000000000000000000010001
100000010110010000000100001000010001010110000000100010100000101000001
110000000000010000000100101011101010000101000011000000100000000000001
100000011000000000100000001000000000110010001010001000010000000100001
110100001000011000000000000000000001000101010100010000101000010000011
100000010000000000000000000001101000000000001011000000110000000000001
100000000000010000100110010000101010100101000000001010000000000000001
100001000000001001000000110001000000001000001001010011101000000000001
100000001000000000000000010000011010010000010001001001000100000001101
111111111111111111111111111111111111111111111111111111111111111111111